WWWWWWWWWWWWWWWWWWW
WPW_W_W_W_W_W_W_WPW
W_W_W_W_W_W_W_W_W_W
W_W_W_W_W_W_W_W_W_W
W_W_W_W_W_W_W_W_W_W
W_W_W_W_W_W_W_W_W_W
W_W_W_W_W_W_W_W_W_W
W_W_W_W_W_W_W_W_W_W
W_W_W_W_W_W_W_W_W_W
W_W_W_W_W_W_W_W_W_W
W_W_W_W_W_W_W_W_W_W
W_W_W_W_W_W_W_W_W_W
W_W_W_W_W_W_W_W_W_W
W_W_W_W_W_W_W_W_W_W
W_W_W_W_W_W_W_W_W_W
W_W_W_W_W_W_W_W_W_W
W_W_W_W_W_W_W_W_W_W
W_W_W_W_W_W_W_W_W_W
WPW_W_W_W_W_W_W_WPW
WWWWWWWWWWWWWWWWWWW