WWWWWWWWWWWWWWWWWWW
WP__D_D_DDD__DDD_PW
W_WDWDW_W_W_WDWDW_W
W___DDDDDD___D_DD_W
W_W_W_WDWDWDW_W_W_W
WDDD_DDDDD_____DDDW
W_W_W_WDW_WDW_W_WDW
WDDDDD_D___D_____DW
WDW_W_WDW_WDW_W_W_W
WDD__DDD__DDDDD___W
W_W_WDW_W_WDW_W_W_W
WD___DD__D_DDDDD__W
WDW_W_W_WDW_W_WDWDW
WDDD_DD__D_DD__DDDW
W_W_W_W_W_W_W_WDW_W
W_D__DDDDDDD___D__W
W_W_W_WDWDWDW_W_W_W
WP_D__DDDDDD__D__PW
WWWWWWWWWWWWWWWWWWW